19 34
16 16 16 16 16 1 1 1 1 1 1 1 1 1 1 16 16 16 16
16 16 16 16 16 1 1 1 1 1 1 1 1 1 1 16 16 16 16
16 16 16 16 16 1 1 1 1 1 1 1 1 1 1 16 16 16 16
16 16 16 16 16 1 1 1 1 1 1 1 1 1 1 16 16 16 16
16 16 16 16 16 16 16 1 1 1 1 1 1 16 16 16 16 16 16
16 16 16 16 16 1 1 1 1 1 1 1 1 1 1 16 16 16 16
16 16 16 16 16 1 1 1 1 1 1 1 1 1 1 16 16 16 16
16 16 16 16 16 1 1 16 16 16 16 16 16 1 1 16 16 16 16
16 16 16 16 16 1 1 1 1 1 1 1 1 1 1 16 16 16 16
16 16 16 16 16 16 1 1 1 1 1 1 1 1 1 16 16 16 16
16 16 16 16 16 1 16 1 1 1 1 1 1 1 1 16 16 16 16
16 16 16 16 16 1 1 16 1 1 1 1 1 1 1 16 16 16 16
16 16 16 16 16 1 1 1 16 1 1 1 1 1 1 16 16 16 16
16 16 16 16 16 1 1 1 1 16 1 1 1 1 1 16 16 16 16
16 16 16 16 16 1 1 1 1 1 16 1 1 1 1 16 16 16 16
16 16 16 16 16 1 1 1 1 1 1 16 1 1 1 16 16 16 16
16 16 16 16 16 1 1 1 1 1 1 1 16 1 1 16 16 16 16
16 16 16 16 16 1 1 1 1 1 1 1 1 1 1 16 16 16 16
16 16 16 16 16 1 1 1 1 1 1 1 1 1 16 16 16 16 16
16 16 16 16 16 1 1 1 1 1 1 1 1 16 1 16 16 16 16
16 16 16 16 16 1 1 1 1 1 1 1 16 1 1 16 16 16 16
16 16 16 16 16 1 1 1 1 1 1 16 1 1 1 16 16 16 16
16 16 16 16 16 1 1 1 1 1 16 1 1 1 1 16 16 16 16
16 16 16 16 16 1 1 1 1 16 1 1 1 1 1 16 16 16 16
16 16 16 16 16 1 1 1 16 1 1 1 1 1 1 16 16 16 16
16 16 16 16 16 1 1 16 1 1 1 1 1 1 1 16 16 16 16
16 16 16 16 16 1 1 1 1 1 1 1 1 1 1 16 16 16 16
16 16 16 16 16 16 1 1 1 1 1 1 1 1 1 16 16 16 16
16 16 16 16 16 1 16 1 1 1 1 1 1 1 1 16 16 16 16
16 16 16 16 16 1 16 16 1 1 1 1 1 1 1 16 16 16 16
16 16 16 16 16 1 1 1 16 1 1 1 1 1 1 16 16 16 16
16 16 16 16 16 14 14 16 16 16 16 16 16 14 14 16 16 16 16
16 16 16 16 16 15 15 16 16 16 16 16 16 15 15 16 16 16 16
16 16 16 16 16 16 16 16 16 16 16 16 16 16 16 16 16 16 16